  ********

* *      *

*   **** *

*****    *

*     ****

*     ****

*****    *

*        *

********  


Maze Solved:

##********

*#*######*

*###****#*

*****####*

*    #****

*    #****

*****####*

*       #*

********##

