  **********

* *        *

*   ****** *

*****      *

*     ******

*** ***    *

*       ** *

**********  


Maze Solved:

##**********

*#*########*

*###******#*

*****######*

*  ###******

***#***####*

*  #####**#*

**********##

