21 79
 ******************************************************************************
         *     *        *     *        *        *              *     *        *
****  *  *  ****  *******  *  *  *******  *  *  *  **********  *  *  *  ****  *
*     *  *              *  *  *     *     *  *  *        *     *  *        *  *
*  *******  *  *******  *  *  ****  *  *  *  *  *******  *  *************  *  *
*           *        *     *     *     *  *  *  *     *  *                 *  *
*******************  *  *******  *******  *  ****  *  *  *  ****************  *
*     *  *           *        *     *     *        *  *  *     *           *  *
*  *  *  *  *  *******************  ****************  ****  *  **********  *  *
*  *  *     *                    *  *              *     *  *           *  *  *
*  *  *  ****  ****************  *  *  ****  ****  ****  *  **********  *  *  *
*  *  *     *  *              *  *     *     *  *     *        *        *     *
*  ****  *  ****  **********  *  *******  ****  *  **********  *  *************
*  *     *        *        *  *  *  *        *     *           *  *           *
*  *  *************  ****  *  *  *  *  **********  *  **********  *  *******  *
*     *        *  *     *     *     *     *     *  *     *     *     *     *  *
*  ****  ****  *  *  *  ****************  *  *  ****  ****  *  *******  *  *  *
*  *        *  *     *  *           *  *     *        *     *        *  *  *  *
*  *  ****  ****  *******  *  ****  *  *  *************  **********  *  ****  *
*  *     *                 *     *     *                          *     *     *
*****************************************************************************  

