21 79
  *****************************************************************************
*              *        *        *        *        *     *                 *  *
*  *******  ****  *  *  ****  *  *  ****  *******  *  ****  ****  *  ****  *  *
*  *     *        *  *        *     *  *     *     *        *     *  *  *     *
*  *  *  ****  **********************  *  *  *  *************  ****  *  *******
*  *  *     *           *        *     *  *  *  *           *  *  *     *     *
*  *  *  *  **********  *  *******  *  *  *  *  *  *******  *  *  *  ****  *  *
*  *  *  *  *           *           *  *  *     *  *        *     *        *  *
*  *  ****  *************  ****  ****  *  *******  **********  *************  *
*  *     *              *     *  *     *        *        *     *  *           *
*  ****  *  **********  ****  *  *  *************  *  *  *  ****  *  **********
*        *  *        *        *  *        *     *  *  *     *     *  *        *
*  *******  *  ****  ****************  *  *  *  *  **********  ****  ****  ****
*  *     *     *     *     *           *  *  *     *        *     *     *     *
*  *  *  *******  ****  *  *  ****  *******  *  ****  **********  ****  ****  *
*     *     *        *  *  *  *  *     *     *                 *  *  *        *
**********  **********  *  *  *  *  *  *  *******************  *  *  *  *******
*        *     *        *  *     *  *     *              *        *  *        *
*  ****  ****  *  *******  *******  *******  *************  *******  *******  *
*     *           *              *        *                          *        *
*****************************************************************************  

