21 79
 ******************************************************************************
            *                       *              *     *  *                 *
*  *  *************************  *  *  **********  *  *  *  *  *************  *
*  *                       *     *  *     *     *  *  *     *     *        *  *
*  **********************  *  *  *  ****  *  *  *  *  *************  *  *  *  *
*  *           *           *  *  *     *  *  *           *           *  *  *  *
*  ****  ****  *  **********  *******  *  ****************  *************  *  *
*     *  *     *  *           *     *  *     *     *     *  *     *        *  *
****  *  *  ****  *  *  *******  *  *  ****  *  *  *  *  *  *  *  *  *******  *
*  *     *     *     *  *        *  *        *  *     *  *     *  *  *     *  *
*  *  *******  *******  *  *************  ****  *  ****  *******  *  *  *  *  *
*  *     *  *        *  *           *  *        *  *     *        *     *  *  *
*  ****  *  *******  *  *  *******  *  *  **********  ****  *************  *  *
*        *  *        *  *        *  *  *     *  *     *  *     *        *  *  *
**********  *  *******  *******  *  *  *  *  *  *  *  *  *  *  ****  *  *  *  *
*           *  *     *  *        *     *  *     *  *  *     *     *  *     *  *
*  **********  *  *  *  *  *************  *******  *************  *  *******  *
*        *     *  *  *  *              *  *     *           *     *  *     *  *
*  *******  ****  *  *************  *  *  *  *  **********  *  ****  *  ****  *
*                 *                 *  *     *           *        *           *
*****************************************************************************  

