 ******************************************************************************

                                 *           *              *              *  *

*  *******************************  *  *******  *  *******  **********  *  *  *

*     *        *     *              *           *  *        *           *  *  *

*  *  ****  ****  *  *  ****  *******************  *  *******  **********  *  *

*  *     *  *     *  *     *  *              *     *        *  *           *  *

*  ****  *  *  ****  ****  *  *  **********  *  **********  *  ****  *******  *

*     *     *  *  *        *  *     *     *  *     *     *  *     *  *     *  *

*******  ****  *  *  *******  *******  *  *  *  ****  *  *  ****  *  *  *  *  *

*        *     *  *        *        *  *     *        *  *        *     *  *  *

*  *******  ****  *************  *  *  *  *************  ****************  *  *

*        *  *     *     *     *  *     *  *     *     *     *              *  *

*******  *  *  *  *  *  *  *  *  *******  *  ****  *  ****  *******  *******  *

*           *  *  *  *     *     *        *     *  *     *  *     *           *

*  **********  ****  ****  **********  *******  *  *******  *  *  ****  *******

*     *     *     *     *  *        *        *  *        *  *  *     *  *     *

****  ****  *  *  ****  ****  ****  *******  *  *******  *  *  ****  ****  *  *

*  *        *  *  *           *  *        *  *           *  *     *        *  *

*  *  *******  *  *  **********  *  ****  ****  **********  ****  **********  *

*     *        *                 *     *              *           *            

*****************************************************************************  


Maze Solved:

#******************************************************************************

###..............................*#####......*#####.........*..............*..*

* #*******************************##* #*******##* #*******..**********..*..*..*

* ####*........*#####* #############* ##########* #*........*...........*..*..*

*  * #****..****##* #*##****  ******************* #*..*******..**********..*..*

*  * ####*..*#####* #*####.*  *              * ####*........*..*...........*..*

*  **** #*..*##**** #****##*  *  **********  * #**********..*..****..*******..*

*     * #...*##*  * #######*  *     *     *  * #...*#####*..*.....*..*.....*..*

******* #****##*  *  *******  *******  *  *  * #****##* #*..****..*..*..*..*..*

* #######*#####*  *        *        *  *     * #######* #*........*.....*..*..*

* #*******##****  *************  *  *  *  ************* #****************..*..*

* #######*##*     *     *     *  *     *  *     *     * ####*..............*..*

******* #*##*  *  *  *  *  *  *  *******  *  ****  *  **** #*******..*******..*

*       ####*  *  *  *     *     *        *     *  *     * #* ####*...........*

*  **********  ****  ****  **********  *******  *  ******* #*##* #****..*******

*     *     *     *     *  *        *        *  *        * #*##* ####*..*#####*

****  ****  *  *  ****  ****  ****  *******  *  *******  * #*##**** #****##* #*

*  *        *  *  *           *  *        *  *           * #*####.* #######* #*

*  *  *******  *  *  **********  *  ****  ****  ********** #****##********** #*

*     *        *                 *     *              *    #######*          ##

***************************************************************************** #

