 *************

  *          *

*   **** *****

* ***        *

*     ********

*** ***      *

*       **** *

************  


Maze Solved:

#*************

##*######----*

*###****#*****

* ***####----*

*  ###********

***#***######*

*  #####****#*

************##

