9 10
  ********
* *      *
*   **** *
*****    *
*     ****
*     ****
*****    *
*        *
********  
