23 61
 ************************************************************
   *                       *                 *              *
*  *******  *  **********  *  ****  *  *******  **********  *
*        *  *     *     *  *     *  *     *     *           *
*******  *  *******  *  *  *  *  *  *  *  *  ****  **********
*     *  *  *        *  *     *  *  *  *  *     *  *        *
*  *  *  *  *  *******  *******  *  *  *  ****  *  *******  *
*  *        *     *  *  *        *  *  *  *     *  *        *
*  *************  *  *  *  *  ****  ****  *  ****  *  *******
*           *     *     *  *     *     *  *     *  *  *     *
**********  *  **********  ****  ****  *  ****  *  *  *  ****
*     *     *                 *     *  *     *  *     *     *
*  *  ****************************  *  *******  ****  *  *  *
*  *     *                    *     *           *  *  *  *  *
*  ****  *  ****************  *  ****************  *  ****  *
*     *  *                 *  *        *        *  *        *
*  *  *******  **********  *  *  ****  ****  *  *  **********
*  *        *  *     *     *  *     *     *  *  *        *  *
*  *******  ****  *  *  *******  *  ****  *  *  *  ****  *  *
*        *        *  *           *  *     *  *     *     *  *
*  ****************  *************  *  ****  *  ****  ****  *
*                 *                 *        *     *        *
***********************************************************  
