 ******************************************************************************

         *     *        *     *        *        *              *     *        *

****  *  *  ****  *******  *  *  *******  *  *  *  **********  *  *  *  ****  *

*     *  *              *  *  *     *     *  *  *        *     *  *        *  *

*  *******  *  *******  *  *  ****  *  *  *  *  *******  *  *************  *  *

*           *        *     *     *     *  *  *  *     *  *                 *  *

*******************  *  *******  *******  *  ****  *  *  *  ****************  *

*     *  *           *        *     *     *        *  *  *     *           *  *

*  *  *  *  *  *******************  ****************  ****  *  **********  *  *

*  *  *     *                    *  *              *     *  *           *  *  *

*  *  *  ****  ****************  *  *  ****  ****  ****  *  **********  *  *  *

*  *  *     *  *              *  *     *     *  *     *        *        *     *

*  ****  *  ****  **********  *  *******  ****  *  **********  *  *************

*  *     *        *        *  *  *  *        *     *           *  *           *

*  *  *************  ****  *  *  *  *  **********  *  **********  *  *******  *

*     *        *  *     *     *     *     *     *  *     *     *     *     *  *

*  ****  ****  *  *  *  ****************  *  *  ****  ****  *  *******  *  *  *

*  *        *  *     *  *           *  *     *        *     *        *  *  *  *

*  *  ****  ****  *******  *  ****  *  *  *************  **********  *  ****  *

*  *     *                 *     *     *                          *     *     *

*****************************************************************************  


Maze Solved:

#******************************************************************************

######...*     *        *#####*........*........*              *     *        *

**** #*..*  ****  *******##* #*..*******..*..*..*  **********  *  *  *  ****  *

* ####*..*##############*##* #*.....*.....*..*..*        *     *  *        *  *

* #*******##*  ******* #*##* #****..*..*..*..*..*******  *  *************  *  *

* ##########*        * ####* ####*.....*..*..*..*.....*  *                 *  *

*******************  *  ******* #*******..*..****..*..*  *  ****************  *

*     *  *           *        * ####*.....*........*..*  * ####*           *  *

*  *  *  *  *  ******************* #****************..****##* #**********  *  *

*  *  *     *                    * #*########......*.....*##* ##########*  *  *

*  *  *  ****  ****************  * #*##**** #****..****..*##********** #*  *  *

*  *  *     *  *              *  * ####* ####*..*.....*...####.* #######*     *

*  ****  *  ****  **********  *  ******* #****..*..**********##* #*************

*  *     *        *        *  *  *  * ####...*.....*###########* #*###########*

*  *  *************  ****  *  *  *  * #**********..*##********** #*##******* #*

*     *        *  *     *     *     * ####*#####*..*##...*     * ####*     * #*

*  ****  ****  *  *  *  **************** #*##* #****##****  *  *******  *  * #*

*  *        *  *     *  *           *  * ####* #######*     *        *  *  * #*

*  *  ****  ****  *******  *  ****  *  *  *************  **********  *  **** #*

*  *     *                 *     *     *                          *     *    #*

*****************************************************************************##

