 ******************************************************************************

            *                       *              *     *  *                 *

*  *  *************************  *  *  **********  *  *  *  *  *************  *

*  *                       *     *  *     *     *  *  *     *     *        *  *

*  **********************  *  *  *  ****  *  *  *  *  *************  *  *  *  *

*  *           *           *  *  *     *  *  *           *           *  *  *  *

*  ****  ****  *  **********  *******  *  ****************  *************  *  *

*     *  *     *  *           *     *  *     *     *     *  *     *        *  *

****  *  *  ****  *  *  *******  *  *  ****  *  *  *  *  *  *  *  *  *******  *

*  *     *     *     *  *        *  *        *  *     *  *     *  *  *     *  *

*  *  *******  *******  *  *************  ****  *  ****  *******  *  *  *  *  *

*  *     *  *        *  *           *  *        *  *     *        *     *  *  *

*  ****  *  *******  *  *  *******  *  *  **********  ****  *************  *  *

*        *  *        *  *        *  *  *     *  *     *  *     *        *  *  *

**********  *  *******  *******  *  *  *  *  *  *  *  *  *  *  ****  *  *  *  *

*           *  *     *  *        *     *  *     *  *  *     *     *  *     *  *

*  **********  *  *  *  *  *************  *******  *************  *  *******  *

*        *     *  *  *  *              *  *     *           *     *  *     *  *

*  *******  ****  *  *************  *  *  *  *  **********  *  ****  *  ****  *

*                 *                 *  *     *           *        *           *

*****************************************************************************  


Maze Solved:

#******************************************************************************

######......*                  #####*..............*.....*..*                 *

*  * #*************************##* #*..**********..*..*..*..*  *************  *

*  * ######################*#####* #*.....*.....*..*..*.....*     *########*  *

*  ********************** #*##*..* #****..*..*..*..*..*************##*  * #*  *

*  *           * ##########*##*..* ####*..*..*...........* ##########*  * #*  *

*  ****  ****  * #**********##******* #*..****************##************* #*  *

*     *  *     * #*###########*     * #*.....*#####*#####*##* ###.* #######*  *

****  *  *  **** #*##*  *******  *  * #****..*##* #*##* #*##* #*##* #*******  *

*  *     *     * ####*  *        *  * ####...*##* ####* #*#####*##* #*#####*  *

*  *  *******  *******  *  ************* #****##*  **** #*******##* #*##* #*  *

*  *     *  *        *  *           *  * #######*  * ####* #######* ####* #*  *

*  ****  *  *******  *  *  *******  *  *  ********** #****##************* #*  *

*        *  *        *  *        *  *  *     *  * ####*..*#####*    ####* #*  *

**********  *  *******  *******  *  *  *  *  *  * #*##*..*##*##**** #*##* #*  *

*           *  *     *  *        *     *  *     * #*##*...##*####.* #*#####*  *

*  **********  *  *  *  *  *************  ******* #*************##* #*******  *

*        *     *  *  *  *              *  *     * ##########*#####* #*     *  *

*  *******  ****  *  *************  *  *  *  *  ********** #*##**** #*  ****  *

*                 *                 *  *     *           * ####...* ##########*

*****************************************************************************##

