21 79
 ******************************************************************************
                                 *           *              *              *  *
*  *******************************  *  *******  *  *******  **********  *  *  *
*     *        *     *              *           *  *        *           *  *  *
*  *  ****  ****  *  *  ****  *******************  *  *******  **********  *  *
*  *     *  *     *  *     *  *              *     *        *  *           *  *
*  ****  *  *  ****  ****  *  *  **********  *  **********  *  ****  *******  *
*     *     *  *  *        *  *     *     *  *     *     *  *     *  *     *  *
*******  ****  *  *  *******  *******  *  *  *  ****  *  *  ****  *  *  *  *  *
*        *     *  *        *        *  *     *        *  *        *     *  *  *
*  *******  ****  *************  *  *  *  *************  ****************  *  *
*        *  *     *     *     *  *     *  *     *     *     *              *  *
*******  *  *  *  *  *  *  *  *  *******  *  ****  *  ****  *******  *******  *
*           *  *  *  *     *     *        *     *  *     *  *     *           *
*  **********  ****  ****  **********  *******  *  *******  *  *  ****  *******
*     *     *     *     *  *        *        *  *        *  *  *     *  *     *
****  ****  *  *  ****  ****  ****  *******  *  *******  *  *  ****  ****  *  *
*  *        *  *  *           *  *        *  *           *  *     *        *  *
*  *  *******  *  *  **********  *  ****  ****  **********  ****  **********  *
*     *        *                 *     *              *           *            
*****************************************************************************  

