 ************************************************************

   *                       *                 *              *

*  *******  *  **********  *  ****  *  *******  **********  *

*        *  *     *     *  *     *  *     *     *           *

*******  *  *******  *  *  *  *  *  *  *  *  ****  **********

*     *  *  *        *  *     *  *  *  *  *     *  *        *

*  *  *  *  *  *******  *******  *  *  *  ****  *  *******  *

*  *        *     *  *  *        *  *  *  *     *  *        *

*  *************  *  *  *  *  ****  ****  *  ****  *  *******

*           *     *     *  *     *     *  *     *  *  *     *

**********  *  **********  ****  ****  *  ****  *  *  *  ****

*     *     *                 *     *  *     *  *     *     *

*  *  ****************************  *  *******  ****  *  *  *

*  *     *                    *     *           *  *  *  *  *

*  ****  *  ****************  *  ****************  *  ****  *

*     *  *                 *  *        *        *  *        *

*  *  *******  **********  *  *  ****  ****  *  *  **********

*  *        *  *     *     *  *     *     *  *  *        *  *

*  *******  ****  *  *  *******  *  ****  *  *  *  ****  *  *

*        *        *  *           *  *     *  *     *     *  *

*  ****************  *************  *  ****  *  ****  ****  *

*                 *                 *        *     *        *

***********************************************************  


Maze Solved:

#************************************************************

###*      #################*                 *              *

* #*******##*  ********** #*  ****  *  *******  **********  *

* #######*##*     *     * #*#####*  *     *     *           *

******* #*##*******  *  * #*##* #*  *  *  *  ****  **********

*     * #*##*        *  * ####* #*  *  *  *     *  *        *

*  *  * #*##*  *******  ******* #*  *  *  ****  *  *******  *

*  *    ####*     *  *  *    ####*  *  *  *     *  *        *

*  *************  *  *  *  * #****  ****  *  ****  *  *******

*           *     *     *  * ####*     *  *     *  *  *     *

**********  *  **********  **** #****  *  ****  *  *  *  ****

*     *     *                 * ####*  *     *  *     *     *

*  *  **************************** #*  *******  ****  *  *  *

*  *     *                    * ####*           *  *  *  *  *

*  ****  *  ****************  * #****************  *  ****  *

*     *  *                 *  * #######*   #####*  *        *

*  *  *******  **********  *  *  **** #****##* #*  **********

*  *        *  *     *     *  *     * ####*##* #*########*  *

*  *******  ****  *  *  *******  *  **** #*##* #*##**** #*  *

*        *        *  *           *  * ####*##* ####* ####*  *

*  ****************  *************  * #****##*  **** #****  *

*                 *                 * #######*     * #######*

***********************************************************##

