8 12
  **********
* *        *
*   ****** *
*****      *
*     ******
*** ***    *
*       ** *
**********  
