31
28
  **************************
*            **            *
* **** ***** ** ***** **** *
****** ***** ** ***** ******
* **** ***** ** ***** **** *
*                          *
* **** ** ******** ** **** *
* **** ** ******** ** **** *
*      **    **    **      *
****** ***** ** ***** ******
****** ***** ** ***** ******
****** **          ** ******
****** ** ******** ** ******
****** ** ******** ** ******
*         ********         *
****** ** ******** ** ******
****** ** ******** ** ******
****** **          ** ******
****** ** ******** ** ******
****** ** ******** ** ******
*            **            *
* **** ***** ** ***** **** *
****** ***** ** ***** ******
*   **                **   *
*** ** ** ******** ** ** ***
*** ** ** ******** ** ** ***
*      **    **    **      *
* ********** ** ********** *
* ********** ** ********** *
*                           
*************************** 