8
14
 *************
  *          *
*   **** *****
* ***        *
*     ********
*** ***      *
*       **** *
************  
